

WE ../parsing/texture1.xpm                 

EA   ../parsing/t e x t u r e.xpm     

SO    ../parsing/t e x t u r e.xpm    
NO   ../parsing/t e x t u r e.xpm       

C  142  ,   98  , 100     
F 255   ,  140  , 0     
                     
                    
                          
            11111111111
            11100000111
            11111111111111        
11111111111111111111100011111111111111                       
11111111101100011000000000001111111111     1
100000000110000011111111111111111                 1111111
111111111  11111        1                         1111111
        
 
       
     
          
       
                                          111111111111111
                        1                1N1     11111111
111111111111111111111111011111111111111111111111100000001                          1
111111111111000000000111111111111111111111     1111111111
11111111111111111111111111111
1111
111111111111111111111111111111111111111111         1
100000000000000011010010001111101
11000001010101011111011110101111111111111111
111101110111010110111101001111     10000001111
11111111111111111111111111111111111111111101
                                          1
     
       
     

111111111